1111111111111111111
1222222221222222221
1211211121211121121
1311211121211121131
1222222222222222221
1211212111112121121
1222212221222122221
11112111x1x11121111
111121xxx8xxx121111
111121x99099x121111
xxxx2xx95679xx2xxxx
111121x99999x121111
111121xxx:xxx121111
111121x11111x121111
1222222221222222221
1211211121211121121
1321222224222221231
1121212111112121211
1222212221222122221
1211111121211111121
1222222222222222221
1111111111111111111